██████████████████████████████████████████████████████████████████████
█"""""""""""""""""""""""""""""""""""""""█..................█.......#.█
█"""""""""""""""""""""""""""""""""""""""█..................█.........█
█"""""""""""""""""""""""""""""""""""""""█..................█.........█
█"""""""""""""""""""""""""""""""""""""""█..................█.........█
█"""""""""""""""""""""""""""""""""""""""█..................████*██████
█"""""""""""""""""""""""""""""""""""""""█............................█
█""""""""""""""""""""""""""""""""""""""!.............................█
█"""""""""""""""""""""""""""""""""""""""██████████..███████..█████████
█"""""""""""""""""""""""""""""""""""""""█.............█..............█
█"""""""""""""""""""""""""""""""""""""""█.............█..............█
█"""""""""""""""""""""""""""""""""""""""█.............█..............█
█"""""""""""""""""""""""""""""""""""""""█.............█..............█
█"""""""""""""""""""""""""""""""""""""""█.............█..............█
██████████████████████████████████████████████████████████████████████
